##########################################################
#############|.  . . . . . . . . . . . . . . . . . . . .|#
#############|.|###################|.|################|.|#
#############|.|###################|.|################|.|#
#############|.|###################|.|################|.|#
#############|.|###################|.|################|.|#
#############|.|###################|.  . . . . . . . . .|#
#############|.|###################|.|################|.|#
#############|.|###################|.|################|.|#
#############|.|###################|.|################|.|#
#############|.|###################|.|################|.|#
# . . B C I S @ . . . . . . . . . . . . . . . . . . . . |#
#############|.|###################|.|################|.|#
#############|.|###################|.|################|.|#
#############|.|###################|.|################|.|#
#############|.|###################|.|################|.|#
#############|.|###################|.  . . . . . . . . .|#
#############|.|###################|.|################|.|#
#############|.|###################|.|################|.|#
#############|.|###################|.|################|.|#
#############|.|###################|.|################|.|#
#############|.  . . . . . . . . . . . . . . . . . . . .|#
##########################################################