##########################################################
#############|.  . . . . . . . . . . . . . . . . . . . .|#
#############|.|###################|.|################|@|#
#############|.|###################|.|################|.|#
#############|.|###################|.|################|.|#
#############|.|###################|.|################|.|#
#############|.|###################|.  . . . . . . . . .|#
#############|.|###################|.|################|.|#
#############|.|###################|.|################|.|#
#############|.|###################|.|################|.|#
#############|.|###################|.|################|.|#
# B C I S     @ . . . . . . . . . . . . . . . . . . . . |#
#############|.|###################|.|################|.|#
#############|.|###################|.|################|.|#
#############|.|###################|.|################|.|#
#############|.|###################|.|################|.|#
#############|.|###################|.  . . . . . . . . .|#
#############|.|###################|.|################|.|#
#############|.|###################|.|################|.|#
#############|.|###################|.|################|.|#
#############|.|###################|.|################|.|#
#############|.  . . . . . . . . . . . . . . . . . . . .|#
##########################################################