#|A|B|C|D|E|F|G|H|I|J|R|S|T|U|W|X|Y|Z#
K 1 . . . . . . . . . . . . . . . . 2K
L . . . . . . . . . . . . . . . . . .L
M . . . 8 . . . . . . . . . . . . . .M
N . . . . . . . . . . . . . . . . . .N
O . . . . . . . . . . . . . . . . . .O
P . . . . . . . . . . . @ . . . . . .P
Q 4 . . . . . . . . . . . . . . . . 3Q
R|A|B|C|D|E|F|G|H|I|J|R|S|T|U|W|X|Y|Z#
